10 10
##########
##########
   #   ###
B  #   # A
## # # # #
##   #   #
##   #   #
##########
##########
##########