8 10
##########
##########
#####    A
##### ####
##### ####
B     ####
##########
##########