11 11
######### A
###   # # #
### # # # #
#####   # #
#B  # # # #
# # # # # #
# # # # # #
# #   # # #
# # # # # #
#   # #   #
###########